R 900 900
NO textures/wall_1.xpm
SO textures/wall_2.xpm
WE textures/wall_3.xpm
EA textures/wall_4.xpm
S textures/pillar.xpm
C 222 ,112,, 255
F 123, 111, 0
  1111   11111  
   1111      11111
11111111111111111111111     
111111000000111111111111
1111110000000001111
111111000000000011111
111110000N000000111111
10111111000000000011111
111100122211000111111
111111111111011111111    
       1010000011   
  1111111111111111