R 1920 1080
WE      prueba/WE
EA Pru/EA

S ppe
C 222 ,112,, 255
F 123, 111, 0
NO  prueba/NO
SO prueba/SO
  1111   11111  
   1111      11111
      11   1111     
     111111
  1111000001111
  111100110011111
111110000N00111111111
101111111111111100001
111100122211000111111
  1111111111101111    
       1010000011   
  1111111111111111