R 1200 2300
WE      prueba/WE
EA Pru/EA

S ppe
C 222 ,112,, 255
F 123, 111, 0
NO  prueba/NO
SO prueba/SO
  1111   11111  
  1111      11111
      11   1111 11    
     111111
  1  1000001111
  1111000111 
11  1222 1N111
  111111  111  111
  1     111     11
  11 1111111 11111