R 1920 1080 
NO ./path_to_the_north_texture
SO ./path_to_the_south_texture
WE ./path_to_the_west_texture
EA ./path_to_the_east_texture
S ./path_to_the_sprite_texture
F 255,255,255
C 0,126,233

11111111111111111111
11111000111010111111
12110011100101010011
10001101111012120001
10211001010110110111
11012011011001201111
10011111011010011111
12001010010021111011
10111101010000000001
11101011001101100111
10001001100100000211
12111101101011000011
11201010101100110021
10110000010000111211
10010100102100001011
11002000100100002001
11020101100002012001
100101021N2010000101
10110012111001010011
11111111111111111111