R 600 600
WE      prueba/WE
EA Pru/EA

S ppe
C 222 ,112,, 255
F 123, 111, 0
NO  prueba/NO
SO prueba/SO
  1111   11111  
   1111      11111
      11   1111     
     1111111111111
  1111000000000001111
  1111000000000011111
111110000N000000111111
1011111100000000000001
111100122211000111111
  1111111111101111    
       1010000011   
  1111111111111111