R 600 600
WE      prueba/WE
EA Pru/EA

S ppe
C 222 ,112,, 255
F 123, 111, 0
NO  prueba/NO
SO prueba/SO
  1111   11111  
   1111      11111
      111111111111111111     
  11111111111111111111
  1111000000000001111
  1111000000000011111
111110000E000000111111
10111111000000000011111
111100122211000111111
111111111111011111111    
       1010000011   
  1111111111111111