R 1200 2300
WE      prueba/WE
EA Pru/EA

S ppe
C 222 ,112,, 255
F 123, 111, 0
NO  prueba/NO
SO prueba/SO
  111111111  
  1111000111   
  12222211N01
  11111111111