R 900 900
NO textures/wood.xpm
WE textures/redbrick.xpm
SO textures/purplestone.xpm
EA textures/greystone.xpm
S textures/barrel.xpm
C 222 ,112,, 255
F 123, 111, 0 
11111111111111111111111
11111111111111111111111     
111111000000111111111111
111111000200W001111
111111000000000011111
1111100000000000111111
10111111000000000011111
11110010000011000111111
111111111111011111111    
       1010000011   
  1111111111111111