R 900 900
NO textures/wood.xpm
SO textures/redbrick.xpm
WE textures/purplestone.xpm
EA textures/greystone.xpm
S textures/pillar.xpm
C 222 ,112,, 255
F 123, 111, 0 
11111111111111111111111
11111111111111111111111     
111111000000111111111111
1111110020000001111
111111000000020011111
111110000N000000111111
10111111000000020011111
11110010000011000111111
111111111111011111111    
       1010000011   
  1111111111111111