R 1920 1080 
NO ./textures/wood.xpm
SO ./textures/mossy.xpm
WE ./textures/colorstone.xpm
EA ./textures/redbrick.xpm
S ./textures/barrel.xpm
F 25,25,25
C 0,126,233

1111111111111111111111111111111111111111111111111111111111111111111111111
1010102010111100110010101110001101100110101001010110010110000020000111121
1011001001000000010100021000111001010010010011000111000000011101000020011
1002001001000010110010111000100110000000101100000001200000110000000100111
1010000001000120001110111011011001000001100001001000000010111100001010111
1111111001100100000111110001100010021100000000010020000000010001111002111
1102110011011000001011000111000100001101001000101120100000101120000121011
1100000011211001000000102010000101111011110100001000101010000101000011111
1101001111001001000100010001010010211110001101011000101110011000001102001
1011000000001010100010011011100002001101100000110101111020100000010010001
1100011110000001010000201010110000000001010000100000001200102011001000001
1120011000100001011010010111011000000100110110100101101101000111120100111
1111002020011100110010110011100120110100111110020111000010100111000001001
1110000110100001000001111101200001000001101101001101200000001000000000011
1100010000200111101002011001120001102100001000000010001101001100100010001
1011100011000011101110011010000001012010100101100000001001101011010000001
1100010100100000001100210011000110111010110101012010011021021010100000011
1110011100010101001000101001100010101000101001011011011110100100002011111
1011100100000101001100100100011000011110110111200211001102100000000001101
1100000101011000011001000010011010001101001001001110110010110000101110011
1001000000000000100001111010010011100101010021011011001001000000101120011
1000000102012100011110000100010000000101000000000101001010001001010000201
1000020101020101001000010011011010101000021101001100001001111002101110011
1000001000100100210000110011010010100100101101011100000100101110100010001
1002010010001110000012001021001010100100000001110000011111011201021010111
1011000000100200111000000100012000101011100010010111000101001010021100021
1110010010000011000001110010010000001011100011002000210110000100020000001
1010110101000111100011011000100000100211000010101001010100100000010010001
1000010010100111010010000001100001000112010110010011111000000110011010001
1000010100111111011110101011001110100100010010000021000102012010101000111
1100000110201010101011010202001000000110100010011100100100100021101000111
1011101201100100000111100101011000010101100111010010100000011111010001011
1000001000100001011100101010100100110011000110110211120001100111020000101
1012111001001000000120001011100011101102110010000100000010100011011100011
1011000102100001101100100001100110111010000110211000100010200100100101001
1001000010100111010110100200102000101110101000001011000001101101010101001
1010000000000101001111100011101111011010010011001000000001010011010000101
1000010000010100000101100111010111010100001000000010001000100000100101201
1020000000100000110010111100000001002011001210000010011111102000000001101
1110111021100020110100102000101020010010100001021211000000020100110011001
1010110000012001000000000210001001000010000100110000111110010001010001101
1000101001100000000001000101000101110101000000011011200001020010000111001
1010101011010010002011100000120001101100220111000000100100010200001002101
1100010100100100000001100000001020001001110100101011100110100000110001011
1000010011111000100111100000000001100001001110100100000010012201010100001
1110100010100000111010100000011000111000001021101000000010012111100100111
1110101011001011012002000120101001111011100000111020101020001120020101001
1010001010100100000111010210111100002012000011001101100000100000100001001
1100001100002111102200010001201100001011000110020021010101000010101001101
1101100010100200011010001010000010101001011000011101121110101101101110001
1010000001001001000000100000001110000000010101010010011100200110000000001
1101110011010101001001100110000101011000210000010012000100200100001001001
1001100001110011000000000000001010000011000001100201010111002000000010011
1111010101000000100011100000001100011100010000100110011011110010010000011
1211001010011100100000011110100110010001100001001101000110111101011000111
1000001011010110112101000111111010011000010011100102000100111010002100011
1011110000110001010001110102111100000001100010010000121011000200111002011
1111000100100010110101000000000010001001110010000000010011111201001102101
1101001021111001200101212111100100000101000010010100011010000010101210011
1010001010010000000110110002120010010000020010002000010200101000101001001
1101100111010001001000011102110101110000020100211001100010010102000001001
1100001100011000100100101000010000001010000100000000000010101110000000121
1000200010010100011002011101101112111001100110100101111000001010121010111
1001000100001100120000111110111011100000110001121101100001101201011000001
1210100210021001011111110000101100011000010011000000100010010010000011101
1011002001100000000101100000011000010010000001011000011110001010001000101
1001101000011100000211011000020010000010000011001100101010000010001020111
1002100110010001000010211000011020100000000000001000010100001010101010001
1000120010010000001010000001011101100001000110000000110011101110001000011
1012021100011101000000010000100011100001010000011111000001010010001000201
1220110010101001010010100010010000111111000001111020001001001102100210111
1101101100001200100010010010001000010100100100111000102010010101110000111
1101001100010110000100110101100110010010011010000020000011010020001001001
1100100000111102021101000120011011000101101001000010000000121100110111101
1201102010000011100100010110011011011110010010000000001111101000100111111
1000100001111011210000001101001110000100010001011000000001001000001100001
1110111011000000111110000001000211010211010000000001120001010011000101101
1110101000102100101001010101211021001001100000111100020000001120010111111
1100001111111000010000011101111010001111011000010021100000111102100001011
1101100021110001200010010011100010101111000010000000000000100101000100121
1000021201010000001001110000100000000010000000010101011000101110000002001
1000001011100011120100000101100100000100000000001021000100000010000110021
1100111000101101010010101000100000000110000011010001001001001000000011001
1101100000011000000100010000201001000000001120211020000002101001000101111
1011111101111000000100010210111120000010010110010101010110110110210110111
1000012111000001000010011120011100000001001001011202100101000001101100001
1200000000121010100011102110100101000100100100000101000010010010000010011
1000010011100000110110001110100110110101000000100110001101001001002100001
1100101001110111001100111000110001010000001120100000000001000010001001111
1110000101000000010111101000001202110110011110201000101120000000100000011
1010110201201001100100101101011010011101011101010000010011010112110000011
1010111010100010200010201101220000000002000110011111101011012000010010001
1120110110200000012100011011020011012010010101210021000100000000001100011
1100010010100000000200102000010001002001110010002000100110100110110002001
1010001012001000100102001000000020011100010010121000111001101000101110021
1011100101100100010100101101110011000102010110101000012000011110110000001
1001101200110100000011001011111000000021010110110100011001000100210100111
1111001000110000120000110011100010000011110000000000111010111000111002001
1011120111001100100011110002000101010101010100002100000110110000001000011
1101101022001101000012111001100000110100101011000000000211101001000000011
1002010111010110011101011120100000000000000001001010000100100011000110101
1100001101010100011000000100000100101100000001011111001001110002000000101
1001111001012000012000000011000011010021001011102000021011000111001111001
1000000012100000011000100000001000110201100011101000002010000000001011111
1012101001000011011112100100100002001110011120002101110100111110110021001
1001000211011000010102000000000102100020000111110010100010000100102100011
1000101001101011000001011011001101000100200000010110000000002010200101001
1112001101001010000110020111111100001011000101011000000001100100010011111
1001110111000011101111110002010111110020000021100001111101100011001110101
1000101010002001100110100100001010121001010110100010001101000000110011121
1000100000001010001000110010100110010001101012210110000111010010000100011
1000102100101110001112100111000001200010010011101011101010110000001201001
1011000100100001021010101010010120100200000000010011102110010000011000101
1000101100200011001021000010001002100001011101100100101001111010100000101
1000001000100001110010020001001100020101011100001001010000110110000011101
1000010000010100000000021001000000011010110001000010001110100000110001001
1100100000010100100000001010100001110101110010000110100110100000100010101
1010111011210010100111010000010011111000010110110101110111011111110201201
1100000102001100010100011100111000001002011100001000000100010001000011111
1001010010101101011010010200101110101010101101221001011100022100111010111
1112001100010002010111000000111001010110010100000001112010110000000100001
1000001001001100200001002100010110011110010001111010010100010001000100001
1100000000000100111010110011011100001011000011011111000010010021011000011
1000101010000010101100002001010002001100000000100020000100011000101010111
1001110000110000100000000001100001010010210000001100011011110101120000001
1000110000010100111001000001010102000110100000111001100010011201101001101
1000000101001000110020200110110002000011001000100111101100010010111000101
1120010100100110021100111001010001010100100000011100110010100001011010011
1011000010011011001100010010110100000110000001010000011000100101110110001
1111010000011011010000100000000100111000000111210100000110010010001100101
1020012000110011101000000101110010121011100001101001121001100100012100001
1011010100010110010001012110020020001001000000110011000000211011011011101
1100001100120000011000000110011010101201101111101010210020010022101111001
1001000100110020000010000111110010000011000001000011010010010002010000111
1010000000010010010001000001010000001100100121010012100002110110000210101
1110100001001101201100011100100001101100011020000100100000021010101001001
1100000110010001000111101110001100111100001000110000002000010110100010111
1010011000001011010110000001100010001000010001012100001010000000100001011
1101101001000100110011110100001110011000010101000000000110101110112112211
1212010200200010100100121011001001111111111011000010011100000001001101021
1100100110010101100100001100111010010100100110010010110001200000010010001
1101110000010010000011000010000101010020110011101100112001101001101010001
1000100111000000000100000010000100011010001210100001000100111011101100101
1000000010000120100001001210001100001100000000020101000201000000011000001
1000101010101110000101100001010210101101110001000020010110010000111010011
1111100100101110001011001111011010100001011001020101010010100010110001001
1000111000201001000010100000110100001001102111100000001100100120010110021
1101100000000100001010210110101010011000200011101020120100111000110100201
1111100100101000001011100010010000011010110000112200010111101101100201101
1101100100101111000201100000201100000010011011010010010120000100110111101
1011000021111101011000100110010111110202111221110000000011101000001110001
1000110010001110110100101020000100101101000001210100010021101010100102011
1110010100110010001001000001101010000001000000000011101011001001110100101
1011000100211010100001000000000100000100101201000010101010011001000111111
1000000001111001010000111100000000000021000201000111100001201111111021101
1212001201011001000101110021000011111011110110001000110010001000100010001
1001010011001100200000100001010120001200000001010000110111011111010101001
1010110000000110000100000211100011101110000101002000001110000000100101011
1200011000010011000111010000001211000011001001111100000110010110000111201
1101010000110011022010100001100100100001111200001210100000101000001001001
1100011100001010001011000101010001000010100000100011001100010100110011001
1011000101011011100001121011101121000000010000100001100101110210000111101
1111102110011111000110000100000110002001100001000001011101110010010000001
1110100100111000010100100100010201111011112121011120000000000112100010111
1000001000100100011120100112000100001110100110111111101102010100101012001
1111001021010101112000020100200000001000100000000100000101100000011000011
1000011011000111100001100000010200001010020011000110100201000100000001001
1000010101000021001001110110210010100110100100002000011011120010010010101
111W001100111000200000101121112120110010111110111021110210001010001000101
1010001101010100000100100010011010000010000100000210210110100100010101001
1011101011000101011210100010111000011100020010110001000100010100110112011
1010100111000111110110000100010011100101011100000000120000010010101011001
1011100001020001100101000201000110210011200101021000110100101021110000101
1011020110001120000021020100010100001001020001100021100000101001100200101
1001000101010010100100000121000000110110011100021211101110001210000001001
1010010011010101011000000011011111001011100000100000110100101101111010011
1100000000001000111101000001010000010011100010100101010010010100011011101
1010200101001001000001000100000011110200110000100011201010010100111012011
1000000201001110110010010000121012111100121010000010010100101101010011011
1110000001000010012210100001121112102001110110110000102011010010021000211
1001100000100101100000010000000000010100000100000000100010011100010010021
1000100111010000101111101110000100201000120010001101010021111000000001101
1010010000001001012000000200110101000101110000001110020101000011000101011
1101001020010000011200010001000001000000010200010000110210001100111010011
1012201010111001111101001111100000011010111200010001100001101101100000111
1101011000010000000102001100100000101101101100001110011020110111111020011
1010021000101111002000000010110001011110000100000201101010100000101100111
1210001110011100100001100100201011000021100100100110010002200111011111011
1110101021101011110011001100001110001210000000000001001000010100112111111
1100110010011001101011010010010000000101010001110020100101010100101000001
1011021100100000000100010000000100010010000000020001011001110010000011101
1101000110010101000001001010000100110000110000001011100100100010000000101
1010110120100101000111101000010002100021000010100011001000011100101001021
1000001011010011000010000010110101001101100001110000110211000110000001001
1110110000001200211000000000100000001002100100000100000000100010000001101
1100210100100100101021111000111110110000002011011011001000100000110000101
1010010100001111000110000010100021001101110000000001001111100100000110001
1010001101001111010201102101101000001000000011010101001010001110010001001
1002021101011000111120000021100000110101000001110010010020000100000001001
1101110001100100100111010000200201010011122001001000102001100100001000011
1111000101100010101210100100110110001011102001011100110010000102010000101
1001001001010100010101021110100010001210001000000111010011010020111000001
1000010001000110011110001010110000101120000111010110000100011112110000021
1101211000101010100000010010000001011011010100000000000001000020000001101
1110000001011002000000220000100101011010100001200011100000001110001010001
1011110001111000001000101101000100101000101001100111100101000000000101011
1110001110111000110010201010011000010000011020000201010112000111010112001
1000100000011120110111001010022100110010110000100101011100001100010000011
1010110000011101020110001101000001000111010000000100011110010101000000111
1000110002000012000101000001101001000012001111000011020010000210011100011
1001002100110110110111101000011020101111110001010000010010001000111000001
1001100101100001000001100002011100120110000011010010101010100110010100111
1001011000001100201010101210000000011100000001101010100000010000002000001
1001000000120100010100000001011001111002010000000000110001000110000102001
1111100000101100001200010000110001010110111110000000001010101000111011111
1001001110000100120010110001110100001100201111010101200121110000110000001
1000201010101011000000110020000011012100000110000211001000100121011100011
1010010111000011000010010001000100100000100101220011201210002001002100101
1111102120100000001101000000101010111000100011100000000100100010001100101
1000000100101010011000011000010010002000000110102000010010001001100211001
1101200111100001000001000101100101000110010001000010100001111020100202101
1111000100000100100100110100221200110000000101012101000001000001000000011
1101000112000100000121011001100200021101110101211010001010100201101110001
1011011111101110101011000100000101200111000000000012010111000001000001111
1010210000101000100002100100000100111001100100001111111000100000101111101
1110121100110000011101000100000100000000000201001000101110100100100011111
1100001010020001011100100100110000000001010000010120020012010121001010101
1011110000000120100000100001101110011000100001000020000000011100011002001
1000000010000100000000000010111100001110101110111010001111010011001002001
1020010010010201111011000002100100010110000001100111010111111011001010001
1010010001001101100000010102101100000120000211100110110000110100100020011
1111111111111111111111111111111111111111111111111111111111111111111111111
