R 5000 5000 
NO ./textures/wood.xpm
SO ./textures/mossy.xpm
WE ./textures/colorstone.xpm
EA ./textures/redbrick.xpm
S ./textures/designcactus.xpm
F 38, 171, 34
C 100, 96, 201

1111111111111111111111111111111111111111111111111111111111111111111111111111111111111111111111111111
1112100000000001000000001010000000000000000000000000010001200000000000000001000000000000100001010101
1001000000000100000000000001000100010210000001101010111111000001000001020000010000001100000010010101
1000000010000011100000000000100000000000000000011000110000100000000110001000110000001000000101000111
1100000000100000001000010010000000001210010000000200110000000021000000100201100000010000010000001001
1010010001001010000010000000001000000000100200000000000000010010000100000000000000012000012000001101
1100000001000010001001001001010010000110001000000000100001000000000010000010000010000000101000100021
1000100000001100001010001000000010000000000000000000100101000000000001100000000100000100000000001001
1011000100000000000000000000120000001000010000001002010000000001010000000010100110000000021000210101
1000000000000001111001000010001101020000000201000100010000000001000100000100010000100000000000000001
1000000100000000002000001101110000000000000001101000001001010020100100000010000000000200000010000101
1000100000000001001010110010110000001000000011010001111001110001000020010001000000121100000100000101
1010000011000000000000000000010000000100000012000010010000000000002000000000001100000000100110100001
1000000000010000000000001000001000001000000110002211110000000000000100001000100010000000000001001001
1000000000000000001000000020000010002000000000100000201101000000000000000021000110100010110200101001
1000010100001000011110100000000000100010100000000000000010000100010000000000200001000000001000002001
1101000011000000101020000001000010000112000000001000000000000000100000100000000101011000100000000001
1000000101100010101001001200000000101100000000020000001000010000021100020010010000010010010000000101
1001110100000000002012000001000100000001101020001010000000010001100000000001000001010010001000000001
1001000000110000000000000000000011000100020010110001000000010010000100001001001000000000000000000001
1000110001001000100000001000011100110000000001000100100200000010011000200000001000001000000000000001
1000011200000011000000000000100000000010100100000010000000010010000000000011100000000011100000000001
1120000001011000000000001010000000000000010010101000110001000000000000010000000100101010010001000001
1000000000200001000001000100000000000010000010100000000010010010000100000000001000000110001010011101
1000100100020100001112000001000000000000001100100100001000001011000000110111000011000100201000000101
1000002010012010010200000110000100101000100010120100000001000100010100000000000001200000100000100121
1010200011000010000001000000000010001001001110000200000211001000000001000000010000000000000010020001
1010100001002000010001010011201010000001100000100100001000100000000000000000001000110000001002100001
1000000000010000000000101010000000000200000110001000001010000000200100010000000002000011020110020001
1000000000001001000001100001100010010010100100011100100101000000000111000000100000000000000000100011
1010100000100100000001000100000000001000000002100010200000000000000100000100000000000000000000000021
100000100000000000000100000000002010E000010000000001100100110000101001000101100000010100001100001011
1010000010100120000010010010000000001000000000100000000000000101000100000000011000100100000001011001
1001000000110020001100002010010000010101011000000000110200000001000000001000000000110011000010000011
1010000010011000100000200010000000000000000100000010000000100000000000010000000020000000010000000001
1010100000000000001010000001100010201100000010000001000100000000010100000100100000010000000001001011
1001100000000110001000101011000001000000012100000000100001000000000000100000002001101100010100001001
1010010000001100000010101001000010000000000010000011102000000000000000000000000000000000000100100001
1100010020000000000010010010200101021000000100000000001000000000000000000100000000000011000010010101
1000000100001110000020000000100001100000000000000100000002000000000100000000000010010100001000010001
1001102001001001010000000000000001000000010100001000000200010001100000000000010001000000000100010011
1010000100000000000001010000010000000020000001000000002000000000000000001000001010011010000000000001
1000000000200010000101001100000000000000002010010001201000001011000000000100010000110000200021000001
1110010000000101102100000000010000110000001001110000101010001000010011000000000000100000021000000001
1100000100010000100000001100100000210000000010000001010000000100010002000000010100000021000000000101
1000110100011100011000000100000000000010001010000010000000010001101100000001000000110110010010001011
1000000011100010010110000101000012000000010000010000000010000100110000000011000100000000001000100001
1100010100000000010000011010000000100000000000000001100000000000010010210000100011000000000100000001
1000100010000111000012000011000001100111101000001000020101000000000000110000000010000001000001010001
1100000001000001000000010011000000000010010000010000000000001000000000200100000101000000100000010001
1010100000000000010000000021010001000000000000000001000000001000000000000000000000000112000000001001
1002100000000001001100001000001000000101000000110001000000000000011011100000100010000020010011200121
1110010000000000010001000000000001000010001000000100010010000000011100001000011001010010010000000101
1000100110021100010100100000011010000000000000001000110000101000000101001100000010000011010100001111
1010000011000010010001001001000110000100000001000000100000100000000000000000001000000000210101011101
1000001000010010000000000000000000010100001100100000000001000100000100100001001000000000001000000001
1000100010000101000100100001100100101000000000000000100000000000000000100020100000000000010000000001
1000001010010000000000000000201000000100020100001000000000000011000100000000000010000000001001100001
1100010000000110000012000000001000000011100100101000010020010000001000000001200000010100010000000001
1000110000001000000000010000000000010001120001000020002100000000001020100000000000010000000000000001
1000100000000000000000000000000000100110000001000000000100100000000110010000001000100001101000001101
1002000000001000000100000000000010100010001000000000002100001000000100010000000101000110000001000001
1000000001000000200000000000101000010100000200011100000010000000011001100001020010000011000001000001
1000000000020010000010010000000000100100000000000001011000000000000100000110000000000000001000000001
1001100002000000010001010000000000002000100000000000000100000000000020000020000000001002000010000011
1110000010000100010100100200001000000001000010000000000010020000000000020200000000000010000200100011
1002010001001000000100001000000010000100100001001000000020110000000000001001000100011001000100010001
1000000000000000000000000000210000000000110100101000000100000000000001000101000100000001010010001101
1100111100101000000001120110000001000000020000000000000000002110000210000000000000010000010000001001
1000111001000000010000010101111000000000011200011000000000100001001000000000000000000002000100011001
1000000000100001020000000000100000000100000000000100000000001000000010000201100101001110000010000001
1000000010210000000010010000000000010000000000000000001010000120000020100000000011011000001100000001
1010110020000000100110001010010000000110100010011010000010100000100000010010000100000001000011010001
1010010000100100000010000200000001001011000001001010000000000000000000000000000000000001110210200101
1000000000100001000001002100000000000100001001101000001002000000000010000000000002000000000100010111
1011000000001000000000000000001100210000000000000101000000020010000000000000000000100000000000000001
1001000001101010010000000000000000111010012000000000110100000000000000000000001010001001000100001001
1100210000000011000101000000000000010100000010000000001001000000110000010011100000001101012000010001
1000102000100010000000010000000110100000002101000000010011000000000100101011020000001000100002211111
1000000010000000000000010000001000002001010000000000000001000020000000000100100020100000000100101011
1001000000000000100001000000000000000000001100110200100000010020010110100010001101001000001000000101
1000000000100000000000000001000000000001000000000000001001001000001002002011000000000000110001001001
1001000000000102000000000000000000100000002010000000000000200010000000000000000100010000011100111101
1000000100100000100000001010100001011000000000110010100110101100111000000000000000000002201000000011
1110100000000000110001000000110001010000000001010000000100000110101000022100121010010100000000001201
1001000000000100100000000100000000100000000000001000000010000010000000000010001000200000010001000001
1000000000001000000000100000010110012000000000010111110020000000010000000000001000000100001001110011
1000010001100000000000000010000002010000010000000000100000010010100000000100000001000000000000000101
1000001000010010020000000011000000000100000000000001100000001000000000000010100020100000000000000001
1000000100000000000101000010000000000000110200011000000001000000110000122010010000100000001000000011
1001201011000100020000110000101000001001000000001110000010000100010000010000011000000100100010100001
1001000000000100000010101000000100000110000101000010000000000010001100000010000010200011000020000121
1000010010000000000100001000000000010000100001010001000000000001001010000100001000110010010100000001
1001000000000000000000111000100011001100100000000000000000000000021000000000000100000001000000001001
1000000010000000010100100001000000002000000000000001001000000010000111010010110011000000101010010001
1000000000100001000000010022000100100000000011002000000001000020010000001000010020001000000000000001
1000020000000010000001200010000010000001000210001000010000000010000000000010000100010000000000100001
1100000110010100011000000010001010010001001012000110100000100010100000000000000000000000000001100001
1000100011000000100000010000000000010010000010010000000102000110011010100100000000000000101000000001
1111111111111111111111111111111111111111111111111111111111111111111111111111111111111111111111111111
