R 1920 1080 
NO ./textures/redbrick.xpm
SO ./textures/redbrick.xpm
WE ./textures/redbrick.xpm
EA ./textures/redbrick.xpm
S textures/barrel.xpm
F 25,25,25
C 0,126,233

111111111111111111111111111111111111111111111111111111111111
101011001010100101010111100101111011011012020111110111101001
100111100000001020010001111110010001001000111110101000100111
12101011001110S001101020001010001002100000101010101100011101
111010110112011111111111102010010111210020000010101000100111
101010111111011000110010120110010100001010001011000110111101
110001000111100010010201210000111010111011111011121000001011
110101010110211211111000011011000110110101111100110111101111
110100111110101100001110000001010000001000110001011011001101
110010111010011001011101010111110110011110111011111111000001
110011100111010100101001111102000010111000100110101010010001
110000111111001111100000101000111111111001001110101100001111
111000011101000211101000100010001101001110001120101101010001
111110110110000001101111111010111101101000010111011011110011
100010010011210010101001011101102100011001010000100111110001
101100100110000110011022001000110111001010021111121011001101
110001010120110011102011110101001000010101010020110010101021
110100110010200101100101001110011000100110010110000110001101
101000100101011010010010110100100111100102010001110100001101
110101110110111210011011100000010000000110001110210001100101
111100111000010111011100001011110011010010011011010101101001
100021010001011010001000001110110011011101011110200010001011
101010110100101111111111021110000101111101100011010100101011
100100011010001101100110110001000111120110000001110111110011
101211111100101100100110011110111010111011101111110111010021
111010000000011220001000011111100101000110210101111120001111
100001010111010111000101000101010111110111110200100111111011
100111110001000000001001001001101101110110101100010001010001
101001111010000101100011101121110110011000001010111111110001
100000111112100110100111111100000001000111000000110101110101
100101101011011100101011110001101010110100000001011010111201
111100111001200000101000000001000001000100000000101010111011
100101011001010011111011001001000000011100100010001000000001
100002101100110010100000101110110110100011101011012011001011
110001000010000110001010001001010000110012000100110011000101
111000000111101100111010010000101001101001011020000011210101
101000111101000100110010101010100001110100010001110000100001
110100110111000111102111111100110001000001111101111000100111
101100000000000011111001000001020010110001000000101010110101
111000011011111000100101101011010101100010000010000221001001
111100000101100100111100000011111110011110100100101110000111
111101000100010000210100101100010110111111010101010100001001
110101000101101211010001100110000111001110001021011020101211
110001000100211001001011011001010111000111001110101100002101
100011110101001000001100010011110010110000110101112110011001
100110001011011000000111010001111000100102110110110100210111
101001000001201110111011001011100101100111201110101010001001
101011000100000000210010011001101100101011102100010010111101
102100000111102001111110010100112112110111100101000001111001
101010102101001101111010000110101101100011100010011111111001
102010010110101110100101001001101011101001101011002101010101
101000010101100011110020010112100100002101110101011110101111
111111111000011010002010111100011111001100001010111110010001
101011011010101110110111100110010110111000101001011121000011
110100011012000001101020000000000001010110101111011000112001
100001100011100010001001000011010112100100110100010011000101
110010011100020110110000111011011010200100011000010110010001
101110011010111110101010111001010000101100000001001210111011
110110111101101111011011111012011011100110100110011200011101
111111111111111111111111111111111111111111111111111111111111
