R 5000 5000
WE textures/greystone.xpm
NO textures/greystone.xpm
SO textures/greystone.xpm
EA textures/greystone.xpm
S textures/barrel.xpm
F 125,25,25
C 0,126,233

1111111111111111111111111111111111111111
1100100000000000000001010010000102010001
1100000010000010100001100100110021000101
1001110010110000101010110000000010000101
1001000001101001010100101000010100100111
1010101100001000000001010000101010000001
1000000000000000101000000000000101000001
1100000120010000011110010000000101000001
1001000001110001000100011010000001010011
1000000010000000101000000000100000000101
1000010000000101100001002101000000001001
1000101100010100000100000100010000111011
1000000200100101001000010000010002000101
1000111100001100000001000010000110010001
1000010000001000000010101100011100000001
1000010110100000000000011001100010010101
1010000210010100011001010110011000100001
1100000001021100000000010100100100000011
1010000000000011000000110000001200000001
1010021101000001000002000000110110001001
1010002100100000000001000010100001100111
1001111001000010010000000000000000000001
1000001111000010110001010010000001000001
1000100110001000011000100000000001020011
1001010011010100120001000100001000010101
1010010100001000000000100000010001000111
1100110001001110000010101110000011101011
1001110101010100110010010010000000010001
1000100110000100001000011110100110101101
1000011100110000011100000001001100100001
1000002111010001110110011010100011000001
1000000011001100000000000000000000010001
1100000111011000011100000000011010001001
1001000100000001101100000001000000000001
1100101100000000000111000100000211000001
1100001000001000001010000001000000001111
11101000101100100000002001101100S1000001
1001001000010001001012000001100010000011
1010000000110000101000020000000001100001
1111111111111111111111111111111111111111
