R 5000 5000
WE textures/redbrick.xpm
NO textures/eagle.xpm
SO textures/eagle.xpm
EA textures/redbrick.xpm
S textures/barrel.xpm
F 25,25,25
C 0,126,233

1111111111
1020100001
1000111001
1000000001
1010200101
1100000111
1010001001
1000100001
1100100101
1010000S01
1110000111
1100011111
1010001021
1100000001
1111111111
