R 1920 1080 
NO  textures/bluestone.xpm
SO textures/bluestone.xpm
WE textures/bluestone.xpm
EA textures/bluestone.xpm
S textures/barrel.xpm
F 25,25,25
C 0,126,233

11111111111111111111111111111111111111111111111111
10000110001010110000200100110001000001000001000001
10000000111000001002100000000121001000000001000001
10001211000100001011010101101011001101111102000001
10000000011110100010000010100000010001010010000001
10001100000000000000000000010010000001000110000121
11001001001011001000101000010000000000000100000001
10101110000001000020010101000000100100000001100001
10100000110001000000001110010001011000001001000101
10101110100010211010000110000000010011000000010001
11100000010000000110101000000010001010000000010101
10000000001100000010101000200001000110000000000001
10020110010001101100010000000010000010011011101001
10010100001111010100001000010000002002000100011101
1000110101000110000W111111001000111000100000100001
10000000010001101101000000000001000001200011000111
11101010000101000000000110100001100000000000000001
10110110000100000001010010000100110000010000000011
10101001010000001011010100010010000000000100001001
10000001010000000011001000002001000000010010110001
10000000101110000100010000110000001011000000000001
10001001010000000000110000010100100000101000011101
10101200111000100001100110101000001110000111101001
10001010100000010100011000010001000010001010010101
10100100000000010001010100002001000000010000101111
10000000010000000000101010000101020001000111000001
11000000100001201011000100000001101001010001210101
10110001010000200200110000100101001000000110100111
11001000101000100010000000001000002101001000010001
12010000001002010100100000110101100001011010001011
10001010010101000000010000000111010011100000001111
10000011100000000000010010100000100100000010010001
10010000011100001000001111000002110100000100011001
10100000000000111101000001100001010000100100210001
10000001102110010101021000011000000100101000010001
11010101000100000000000000010110000000000010011001
10010100000000000100000102010000000010001101110011
11110000010000000001101000110000000000000000100201
10000000000000100010000110000001110001001001000001
10101000010100000010000000000000000001000001000001
10011100010101100010111100000011000000001001001101
10000011000000000010000000110001010011012100000001
11000000000010100011110010001100000000111100010001
10100000100100210200000001000001001000001100000111
11100000011101111000001100000011000100010000001001
10100001100000000000011000000110001011010010000101
10001000000110000000001000001000110100100100101111
10000000021000000000100002000000111000010000010001
11001110010101001201000100000100000000001101000011
11111111111111111111111111111111111111111111111111
