R 1920 1080 
NO ./textures/wood.xpm
SO ./textures/mossy.xpm
WE ./textures/colorstone.xpm
EA ./textures/redbrick.xpm
S ./textures/barrel.xpm
F 25,25,25
C 0,126,233

11111111111111111111111111111111111111111111111111111111111111111111
10000001000000010000000000000010011000000111220000001000001000010001
11000000000100000000000000000001100001010101000000001000020000011001
10000000100000010001000010000002200000000000000010100000000100000001
11100000100010000000100000000000000020000001110000000000000110010001
10010000100010000010001110010000000000001010001001011001000010000001
10020000001010100010202000000000200000100000001000000000101110001101
10000100000010000000000000001000000110010000001002000020010000011011
11010100010000000010000011001000000100000000000000110010000000010001
10010000100000000000000010110000100000000100200001110100000000000001
10000100000000000000020000000002000000001002000010010100001000000001
10000000000000000000000101000100001100100001000000101000000010001011
10010001000000001010110000000010000000001000000101011001000210010001
10000001000000000100000110010001010000000000000000000100010001100101
10100000000010000001000000000000010100000100000000010000020010010101
10001101000000000001000000010100000100010000010000010000000000100011
10002000000100001010000011000101100010000000001110000010000000000001
10010000100100100001000000100000020000010000001000000010000110000001
10010000101000000010101000010000000000111000200010000000000100000111
10100100100000000000110000020000000001001001100010010001100021000001
10000000010000010010100010000000000000010000101001000000000100001001
10000100100000000001000000000001000100000000000001000010011000000001
10000100000010100000000000000000000001000000000100000000000111000001
10000100011010010001000010100101001000000000000010022200000000001001
10000000000000011000000000001001000110100000200001000000000000010001
12010000000010100001001000100000000000000011000010000100000001000001
10000000010001000000100001001000000000100000000000000000000000100101
10010000000001100000001010000000000000100000000000000000100000000001
11100100000001010000001000000000000000000200000010100000002000001001
11011001000100001001000000000111000001010010011101010001101010000101
10000000010000000000000000000012010000000010100000100020200100000001
11000110000100000000000010000000000020000002000002000000000001000001
10001000000000001000000010101000000001000100000000001010010101001001
10100001000000011000000100000000000000100000000100000100000000100111
10000100001010000010010000000100010120000010010000000001010001000001
10000000011100001100000001000000000000010100000000000000000010000001
10000121000000000100001010000000000000010000000000001000000000000001
10011001000000000000000001001000000001001011000000011100001000000001
10000000000000000000000200000100001001101100100000010000000000100001
10000000112000011000000000000000010000000100010000010002000000000011
10001010000010000100000101000000001000100000100000000000000000001001
10000010000200020010000000100100000000000000000000111010000000001011
10000102000100000120000000000011000100000000200110001100100101000001
10010001000000100101000000001000200001001010011001000000010000110101
11001000000010001000000000000000000000100010000101000101020000010111
10000000001002000000110100000000210000000000000000000000000000100001
10000000000010000100100000110011000001000000000100210000000010101001
10000000000000000000000100000010002000000000001102200000000000000101
11020000001000000000010010000000010000111120101000010012000000101001
10001000000010000000000000100000100020111010010100000100000010001001
10000000100100001110000000001000000000000000000000101100100010101001
10012100000001000011100010000101001010000000000001100000000000000001
10000001000000001000000000000100011000001000000010000101100000000011
10100000200000000100200000001100000000001000000100100000012010000001
10102000000011000100001000100000000011000000000000100000000000000011
11000000000000001000001010000010000000010010000000010100100000000001
11001000010011000000000000100010000000000000000000000000001000010001
10000000101002010110000001001000000001000001000010000000000100000001
10000010100000010000100000010200000000000000010000000010000100000001
10000000000000000000000000000000001000010002000000200100000110000001
10001001000100000000000000000000001001000010000000100020010000000001
10000010001001000101000000000000000000200000000100100000000011020001
10000000001000000020000001010001000020000001011010001010100010010011
10100000002000000000100000010000010001010000210010000002110000000101
10000000000000000001101000000001000000000000100000101000110010000001
10000000000000000000000011001000000010000100010010000010000000000011
10000101010001000000000000000000100010010100010000100000000000001001
10000000000000001000000000000110001000010010000001000000000000000111
11000000100010000100010000000001010010000001000010000100000100001001
11000000001000000000000000001000100000110000001001001000000000000001
11100000000000000000000000000100000110000011000100000101000000001021
11000000000000000000101000000002000110000010100000100010000000010001
10000000001010000000000100000000000001000000010000000000000101001001
100100000110001000000000010000000000000010010000N0020000000000000001
10100000000010010010000000000001021000001000101001100000000100100001
10000100000000000001000000000000010000000000000001000001001000000011
10001000000000100001000010000011000000000100000000011001110000000101
11000000000010000100100010000100000010000000000000100010000000000001
10000001001000100000001000100000000000200110000000000000010000110001
10100000020000000000000200000000120000000000100000000000000000200021
10110000010000110010000000000000000001100100001010000000000100000011
10000010001001200100100001001001000000000011000010101000100000000011
10100000200100100000000101101010010010000000000000000020000010001001
10000000010000000000010000000000000011000101101000000000100000100011
10001010001200000000000001001000000000002100100010000000000000000001
11000000011000000000000001000000000000000000000010000000001000000011
11110000001000100000000000000010000000110000000000000010000000100001
12001000100000000000101100001000000100001000000010000000000000001011
11100000000000110000011100001000000100000000010001101000000000010001
11010110010000000000010000001001001000000000100000100011000000000001
10000000000010001100001000100000000101000011001020011000010000010001
10011000000000011000000000011000111010000001000000000000100001001001
11111111111111111111111111111111111111111111111111111111111111111111
