R 1920 1080 
NO ./textures/wood.xpm
SO ./textures/mossy.xpm
WE ./textures/colorstone.xpm
EA ./textures/redbrick.xpm
S ./textures/barrel.xpm
F 25,25,25
C 0,126,233

1111111111111111111111111111111111111111111111111111111111111111111111111111111111111111111111111111
1002101012100100012010001101010000101100101011110010011010111110100002011111012210111101100111110111
1011011101011001102011121111011211101111111120110111010112101011121111201012210101111101102111111101
1111110001021111110011101111111111101012110101101110101110011110200011101012102010121111210121101011
1210011010011110111111000101101112011111010000101111110111101111210111110101111110102111101121111011
1000211111110111002111112110011011211101111100111111121010111001100101102211111011000021100110201011
1111111121101111101011111011111001112111101111111001101110000100111121011111120110111011110102101111
1111111112110111121111001000001010011111102101011001100011111100111100120110121101111111001111102111
1012011110101002110100021122101120011020211111111000201110111111001021211010111101110111000111110111
1111111101110111111211102011111201111200111101111111101001001211112110101101111110111111101011110021
1111111211101111010110010001200011101012011110011110101011110111010101011110011110111101110001211111
1111110011100111102210110010011111011010020100112011111110011010102001011110111112210111101200011101
1121010100101111111101001S01111100001111101211110111110101010110001011021201100001011011011110111111
1101211111101011010101100110011111001111111110100111110110110102111010111011001100201001011110111011
1111210101100011012111001101001012110100101111110121011001111011111112110010101112112111110011011101
1101110111111120101001101110011111120101102111101111101111111120111201010112010011011111110110110111
1011101011122011001111011121110111010101001000011211010010111101110121121112101001101102101000111111
1110111211101111111001011111002110112110120101100120210101001100111110011110112111210111021021121111
1111010201111000110121101001111101001101101011001100101012011121111111011100011111102111011111101101
1001111110111121110101111211112011110110111010101101111101011111111011111111111011201111001111001101
1011111010011110111010120111110000011101001111011010011111110112110120101011000011111001001001122111
1010111110111101011110011020110020110110110001101111111111110112001111011100111110200012101012100111
1101111111111112112111100111110111111122001011121111111012110211010002101110111110110011211101101021
1101100011110110022210111110110111011001111201100111111210120101101011020111112120111111120110110111
1110111110202110110110111001111110100111000001111011101010110110011100111101101210010011210010111111
1100221110100001110110001111000010101001110111211111001101111111001011201210110121001011221111011211
1111111111111110011111110011000111002100111011011110111011101110121101101101210121101011010001012121
1010120021011011001101111211012011220110122110101110110111011021121101010100101101111001011101211111
1101012011001100111001011110100101101001111101102111111001011111110100001011110111102111111110111111
1211111111111011111101010110111011111111210111012011111111111011010110111111210100100000110110101121
1110101020000111001101201112010101111111011111010111011000102100012000211111112100101111102110001101
1110111111111201011111110021101110111121110101101101111010000111101201011110102100000111111110101111
1001101110111210111111011011011001110110100101111010211101021111210100111000001011111110101111011011
1211111111110111011011111110100201001100111011001110111011111110010110101112112110111110011212011111
1111111011211111010111111011220111020111011011100111102001100100101101011111011101011111121011111121
1100110111010111111111111111000112110001101111111100121100010111100111111100110111110110100010100111
1111111111021112110111011021000110111110111011120121001110111102102011021011111111201100011211101111
1110121011010111111111012100011101011111111011111101111011110111101112101100111110011001111100101011
1021011001201111111101011111111101102001111011111111111210010110111101102111111001120101111110112011
1111111001101001111110010111001100100111011022012001101020110011100011011111100100111111222110111011
1110211211112000010111100121111010111111110101111101111020110101111102010111110011110121210000211111
1001010111010021021111001110121111011112112111110200111012111100011001111110111110101011111110001011
1110001111011111111011111010010111011111101101001011111111111101102110111010000110110100000000111111
1011110201010101112100110012111111121121110111101101201011111011210010001200111011001100110011110111
1012111100111011110111010101110102020001010010110112110111111110001111001111012010000111111110101111
1111110111110111110110011011011211001112110111100101010100101111102121110101000110111110111110110001
1111001110101011001110111120021010011101010111111111101110011011111120211121101111100011110111010101
1211111210111100111010110011002111011011010212101002111011101100110100101111211001111101011100120111
1112110110010000111001111111000210111101101010011011101001111211010111211111011001111011110110011201
1211102111101021011110111101001111012000111101111200011101112010110200111010110111111111001011101111
1211011011111112111101101120011011111110011111001100021010110111121111011011111111211110121111100221
1021101111011011111110011211101101011011101111011011110201210112011211120112110111111011010110100101
1021122111111111101010011002112121010001111112001001011101021110121001110121100110112011110011110011
1110011101111010121100002101011100021111101111110101111100011111011101001120201101001011001111100011
1012111111010101011101111001111101100111001001100110111111101011111110112011111110011101001111111011
1111220211000112110101111111111111112101111111020011010112102021001112110111012011210111101111012201
1011001111101101012101021010110110011110011011101101111111010101110120121101001001110010200111011211
1021101110111111010121002011111111011101110101120010111110121010111110022001102201001001101001100101
1010110110111110211010010210011110101110010110001001210111110111001111001111110000110111111111011101
1110021121111001100100111011101111111101111110101111102011111011021011110111111121110101020101211111
1101111011101111101110110111102101001010021110001101001211111012111110111011111011110101010000201011
1021100111111110110111112101111111011010111000111101101201011111010111111221000101111111101111100121
1112110101111100112010111101111000001101120110100111011101101111201110011121011010111111110020111111
1111111111121101101111021002110000110011011011100100101100111110201001001111101001110112001101111101
1111111111101101111101111111001010021101011012111011020020111001111111021110111011001111111111002211
1221110110111111201100101011011111001101110001110112011101010102000010110100201111100100011111011111
1111112002010111001100101111000111110111101112010001121110111101022111111111111111111111102001001111
1110111101110211101101111201101110011110011000110010101011011111100101101111100111101210111000101001
1101111101011011011101110121121111111111111111111101001011111111010111110011101110100010111110111121
1101011212121001112211001011101110100101021110111211111000101001110100111012111111111100110111111211
1012011101100111111111101112121120112111000110111001210100010111110110121111211201011110110102110111
1102001101112101011111111112111001001100110011102110101011121100100101111111110011001201111110111111
1101000101011001011012101001111012111111101011200011111101111011001101111011101001110011011211111101
1111111021011001101010011011010010101101011012100111111100011101110110100110111010111110101111112111
1011011110111001111211111121100010120110100011200011111200000111011100010020222101011012001011110011
1211011111111111101111001010111111111111020001111111011001002200001100111102110120110011011111011111
1100111011101001111110010101111110111111101101201111122111110001000211101101001101111111102112101021
1111121111111011110010111011000111100000011101111101101110110021011001011110111011101101020001001001
1111110110110111101121120000101001011011111111111121100021010111101011010111001110100101121010101101
1110000100111101100011011011011111111111110111001110001111011102111001100100010010000111101011101101
1121110011011001121001100002011111111101111111111010111111011110111111010111100101110111111001120211
1221000010110011200011101211010100111101012101101011101211111010110111110010110101111111111110011111
1110011101110101111112100111010110111110101211001101101011111111100121111110111111111111011110011101
1101121110110111111011111111000100111211110111111000100121110010111200011101110011101011111111121211
1011010110111111012111101001010110110101002111011111120210020111211111110101101100111010111101112111
1110111100110221112010100101100111011111101110101111010011111011111111111111111111111101000011100121
1210100201111111111111010011201101211112011100111210011110110111102000011011011111101112101111110111
1010011211111112102000101111110112100211111001111111102111202011111111211111111101112010000110111101
1110111110001201111111011011021211111101111111011121011011111012200001000011011000211201111011211111
1110101110101001001000111110011111101111211111101101111111112101110121000110011111111111101011111111
1110000001121210012111021011012210010111111000111000111010220121000101011100120112011011110101010101
1011111100021111111021111001210110001210111000012000111011101021011011111111110111111121012110210111
1100011101000111110110111101111111111101200112111011110111011120011121111011100110111012111111000201
1120111111200110001010101011111011111110100101001101112001101110111111111111100101111100101111001201
1110111100211111000111111111111111012111211011101001001110110100110111211101120211120111120110111111
1101211201101112111111010121111011001101111111110100212111120111101110111021110000110111012100101011
1122001100011211101102012111112101111011011111011111111111001021001102011111111011110101010100011111
1010211001101100111101111101120010100121101121101112110011111101110112011111000110110011102011100011
1110101210200111100111001021100120101201111000110111200100110100110111211011110022111111110110100101
1111111111111111111111111111111111111111111111111111111111111111111111111111111111111111111111111111
