R 1920 1080 
NO ./textures/wood.xpm
SO ./textures/mossy.xpm
WE ./textures/colorstone.xpm
EA ./textures/redbrick.xpm
S ./textures/barrel.xpm
F 25,25,25
C 0,126,233

1111111111111111111111111111111111111111111111111111111111111111111111111111111111111111111111111111
1110210101101110100000111011120010000012100100000011011010000100001111000111010211000001121001110001
1010011100200021001000100100120111001010120010001001102110111010011210100100000200111000000101111111
1010100111002010111010001011101000101012001011101011011101010000201101001001000000021010001111110011
1000000100111110111010111001011002101010101000100010111111001111100000102101010111101012110110001111
1100110001211101111110101111101101101000011010110000111111101200011100010001011100010100100001110101
1100011000200101100010001010010001010011020110110011000101001110211111011001002010000010021011010111
1101010001001100111011011001000010110010111101011110110011000100101000110011111100010102120000000011
1111001101100110102011011100010102000000100111101010011001001001001011011001111010001000002010001211
1002100010211100121111001100000011010101100100010110121211000010111011100102110112011100011110010201
1200110001112010010101112010001100011110201110001001201101010021211210011000111000110012111201001011
1110121000010001010101100100010111010010001011010021110100101100011001011001111102101102011010100201
1000001001000011101000011101000011100001000111000011101010100101010101010101101021111200110102101011
1000011010001201001011110210001100000010100010102110110011020100211110000100011011101001001000200111
1100011110000010010112011000011110011011020011001110021110101001101100101101201010100111011000010001
1010020101101100001112110011010101000002001110100011110011010110000000011110010011011001100001101001
1101101011022001100000011001000011000201210010010000100010000101100010001000001100111111100110111001
1100100000011102011100100010011101001001010110101001000000001011010002000000000112000001110010011011
1020110111011002010111000010011100011101012000001001010100000100000102001110111110011000020100011101
1110000001101012011001000010111011110100001020100200100101110001110010101111110110110200100011101021
1010010001000000102100011120111110001000100101101100000001001010100020101101001111010010101011001101
1010100000101100001101001201000110110000010000002000000110111000012021010001201100001011000200100101
1100101100100100101000200101111100000100000001111110111100101110100012001111101100000121001010111101
1100002100001020100001100000000010011000001000111100100100011010021011000100010020010100000100100011
1100211001011010100000011101110000011010101110110001112100110110010001111101110101111100011001011111
1120102011100100002000110201101000000111001100100021020000101020200011011000011001111011111000112011
1000100000000010110110011100100010001000100100011100011010001111101120000000101111000101100111000001
1011101001021010111100110100021111000110100010021101012111111110000010100100001100010100012111001001
1100101010010000100001000120210111000001010110110001000110000000010000011011201011010001120100010011
1010201110101010011210000100101001010101101100012000000011001001110100100100011210020111112110000111
1001010100000200011110200102001111012010101101011010011110020011020002110101101001000000111001011001
11110011100110111020000100200001011111011000100100000100100001010101101110N1011210111101210010111101
1010021001010001010201120020000101000011010100112011011210100101001001100101001001101011011200111101
1001000101001101111110100111000000111000011100011110100120011111100000101000011000011100110011000111
1101101011100100101211111101001101011101111012001001101111200001001120100100210011101101110100110001
1012000112001010001111111121110000000001120102011001111220011101010110001000001000001110010111110021
1010111002011010111001101110100101011000010020100120101001101101100000010001100000111001101011100001
1011001111011001100012101011111001100111010010210001101000011102001110121011010000100100011110120111
1011100111011000101000011111111010100101200001012200001011120000111011011002120100101002011000012001
1112111010010111000010000111010001010100101011100100000110010100020111001011221100200100010001011011
1001111010100011001101111001100000110000100120001011101001100010110010021000100100100010101001101101
1201110010111000100000000012000110111000010010000111200110101101001110111111001100000011001101110111
1000111121101101100011100001111011011001111011101000220101001010111111010101110100001020100110101001
1201210111001000110011101001001011110101001000001001000110110100000101011211010100001101101100102101
1020010012100102010111011100000012101001001211000110100101001012110011011111100101011011111000111011
1011011100110021000020110100011011000112100010001201101010110100111100001101011002000201110100110001
1000111111010100011112101100000111100000101011010011000210110010010021001000100101100001011000010011
1001111001100000101010100000111010210100111110000002110111001022110101010001001010010111111001010111
1001001020000011100011011100000200210111000102101000011000011111120100100111010001111111020101100111
1001001100110100200011110100111010011100010001110100010010001110111010100011002100101000111201100111
1010100010000111101100010000111001010011001110100010110101001110011011011100100010100101101110100001
1000011010000000001100010110001110110111011110112101010100110121000000000200010111101100011110001111
1100011010011110100101101201100110011010101001001011201100102100101100011110111110211010010011001121
1011011100110001110000000000011010100000101011100000010010001002201111101011101010000001011000111101
1001110000010100011100011110210001110011121111000000110111000000112100001111101120101111000100011101
1021210101012000101210001011000000100111110010110010101010012000010100001011101000000110000101200211
1120101000002111010011111001000112000011201111001100102010111000100000100101011220100000010101002001
1010010010111010111010001012121110000000000111111021110010110010002001100100101111010001100110010201
1010010121110000000020010000021000100100201000110111000121101111111202000020100001011111000001100121
1010101000200120001100000011110112010201110100100011000111100200210010010010101001001010100112100001
1000101110121001011010111011011011101101111000111010101100011002210000110102000200000110110010011011
1101101202021000101010110112111020211111011211111001010100001101112100111000101100111111110011101101
1100110010001100111010101010000100012010010001011000011011100001001010111011001001201120201010101011
1011100021111110010001110010111111100101000000010000110001101101101011111202000011000011111110010111
1101110001110000020010100010011021110110110101110001000001111020101112011112000001000000011010110101
1011000001101001110000001102100010000200110111101001111011111200001110010110110110011211110101101111
1101101002101010010011000111000100101101011101102000001200001100201012011111101001110000111000001001
1000100000011212111110000100100012111111011100001100100101200021100101101010010000102200011100001101
1101000111100111001110110100010010000110200000101010000012200101011100111110100101000001110111000011
1010010111001212100110100001111010000200010001000000011101000001000210010000112021100100010110001101
1011200100011100110101011001110102100001010111210100011001110000001101120001001100001000010112101001
1001101022021011211110121101000000010011222121111100001011100100100110000011100112000010100010011101
1100011010112100012010110110011001101011011101011000010021101001101010002001101010111001010101100011
1011001100111001110000011100000011002101000110100001110011102001002110100100101101110010101111100011
1111000100001100201010001010000010101100101000100111000000001100110010111001110010000110011110011101
1001001021001210021000102001101111101111000110100111010012010010001011200211110220010001111100011001
1200000010111110100001010110021020100111101102120112110010012101010011001110101100011100111000001111
1010000011000101011201001000000111100001110100121000000000011110001000111000010100011110000000111111
1000001000000101001101000000111100100111100120000001010122000010000101000110100000101010001010011001
1201011000110000000000200020000100012022100100110012011201100111000010110000001001011101100211011011
1000110011011010011111200011101101011110100010110101211100011001111111001011101100001210111001010101
1010100010101011011001102001100010110120111111010100211101112101101021110101010000010000010010010011
1002110101111000001102000101111101110111000220110210000011000001000100120010111112011101010100101111
1120111121001000011010101010001110110111101000111001102000100000100011100000101010010111011011001011
1000111011001000111200000001001001001002101100000100111120100100210101110000100001000011011012021011
1001101120011001110011010020010111102011020110021001001011011000000000101010101211110001101011101101
1111100021001121200101111001001010000010100100121110011101110010001010101010110111011011101002110021
1100101011111111010010010010021110001101100111012110101010100010010020001011110021100201101201010101
1000010001000000010001001111100011100000000001011011101100111000001110011201100001110010111110012001
1011010110011000011001010110000010010101110000010011110001110101110201101011011011112010101112001201
1110012000001101111100000001000010010000111101011001000011212010001001011101011101000011011100000111
1001110111100000012101001101110100111011211101001110101110110100101100001110000001000001101101011101
1101111011111000112101000011010101110100001110110200021010100100001100210010000100100200101001110101
1100100111010011001001011010110000101101111110101101102000000001111100100100010111002011110010011111
1110000100111011101200010100100012110010111100012100221101002100000021002101011001000102211100000001
1000002111011010010011101100000010000020121101020112010000110110101100001010010111101011020101110011
1111000100001110001000001011110101110101111010211100110111000100111120000010001010101100101111021101
1100101100010111200101100021002000001011000110111100001100010010120100100001011011011002011000120101
1100212011101020110000101001011100000001110101101100010000100110001120111010011011210100111010121011
1111111111111111111111111111111111111111111111111111111111111111111111111111111111111111111111111111
