R 1920 1080 
NO ./textures/wood.xpm
SO ./textures/mossy.xpm
WE ./textures/colorstone.xpm
EA ./textures/redbrick.xpm
S ./textures/barrel.xpm
F 25,25,25
C 0,126,233

111111111111111111111111111111
100100000000000000000000000001
101001000000001001010000001011
100000000000000010000000000001
110000110010000000001000010001
100101100001000000001000000001
100000000000000000010000000001
100100000010000000100000000001
100000001120000000010100100001
101000000000000010000001100101
100000000000000000000010010001
100000000000000000000000000021
100000001100000000000000010001
100011010010000000000000000001
100001010001010000000200000001
100000000000100000000100000001
100000100000000110200000000001
100001000000010000000000000001
100000000000000100000001000001
100000000100000100000000002001
100000010000000001000000000001
100000000010000000000001000001
100001000000000001010000000001
100011000000000000000000000001
100000000000000100001000000001
100001000000001000000000010001
100100010020000000000000000001
100000000000000000000000100001
100000000000000000000000000001
100000000000000000000010001001
100000000000000001000000000001
100001000000000000000100000001
100000000000000000000001000001
100000010001000000000000000011
100000000000010000000000000021
100001000000000000000010010001
100000000000000100000000000001
100000100000000000000000000001
100100000100000000000000000001
110001000000110000000000000001
110000000100000000010000000001
100000000001000010000001000001
102000001001010000000000000101
100000000000000000100000000001
120000200010000011010100010001
100010000010000001001000000001
100000100000100000100001000001
100000000001000010000000000001
100000000010000020000000010001
100100000000120100001000011001
100000000000000000000000100001
100001000000010000000100000011
100000100000000000000020000001
110010000000001010000000200001
100000000100000000100000000101
100000110000000000000200000001
100020010000100100000000000001
100000000010000000000000000001
100001000000000000000000000001
100000000010000000000000000001
100020000002000100000100000001
100100001000000010000000000011
100000000001000000101000000001
111000000000000200010000100001
100000100001001000000010000001
100101000001000000000010000001
100010010000000000000000000001
100000000000000000000100000001
100200000000011000000000020001
100010000000000000000000010201
100000000000000000000001000001
100000000000000000000001000001
100000000000000000000010000101
100001000000000000000000000001
100100000000000000000010000001
111010001000010000000000000001
1000111000000100100010000000N1
100010000000000000010000000001
100000200000200201000000000011
100000000100100000000000000001
100000100000000000000000000001
110000000000000000000010000001
100000000020000000000010000101
100000000000000000000001000001
100000100001010000001000000011
100100000010001000010000000001
100010000110100000000101000101
100000000000000000001000000011
100101000000010000000000000001
121001000000000000000000100001
111111111111111111111111111111
