R 1920 1080 
NO ./textures/wood.xpm
SO ./textures/mossy.xpm
WE ./textures/colorstone.xpm
EA ./textures/redbrick.xpm
S ./textures/barrel.xpm
F 25,25,25
C 0,126,233

1111111111111111111111111111111111111111111111111111111111111111111111111111
1000000001200000001002010100000010010100000000110101000000001000000010101011
1010002000111000000100000000000000011000001100000010100100010001010000100101
1000000000220101110000012110010001010000000001101000000000001100010010010011
1001011000010000000000101110110010001000001000000111000000100001000010100001
1020000000000001010101020010110210011000010000010000101100100100010001012221
1010000100000021020001122100010010001000110000000200000000000000000000000101
1000000000001020000000200000000001010100000111010001100100001100000000000011
1000110011000012000100021010000000000000020000110011001100101200001101010011
1000001010000100121001010111110100010101000001001001011000001111000101100101
1000000100000100000100010011000101000000100011000000010110010001000000000011
1000000000000200010101010010000000002000010010100011100010021010000001000001
1001100011000000000000120010000000000000100100001010100100000000000100000011
1101001200001002100001100001000202000100011010010001100100000011001011001001
1200000100100010001000010000011021101000000010010000100110101000221010011001
1000001002000001100000100001000000100001210101010100010000000100020000000001
1000100001000100001100000001000101010001010200000000100000000010012000000001
1000211111000200211011001011110101000000110000011000101000011010000001000001
1000000001001000000100110010100010000000110000111100000000000102001010000001
1000000000110000010010200000000010110010001010100111000101110000000001001101
1001000000012101010000010001011000100011000001020010101000000010100000000001
1000120000202001000100000010100001000000011001002000011000001020201000010001
1120100000001111100110102000000222001100100111010000010011000001000000010101
1001000101001000200000110000001001100000100100001000001001110110001000000001
1000000000010011000021001000010010200010000100101010001000000001010010001221
1110000001000000010001111010100100100100010011001000000100100111110100001001
1200000010200100100020210000000011101001100000220001100010000100000000100001
1011000000020010000000201001000101000001001000011000100010100010000001000011
1000100000110000100000000100000000000100101211000001010000101000110100001001
1001000010101000011001000100011100100000000010100000110000001000100010101001
1000100000100000001001000011100200010000000000200012001101101001000101112021
1010000000020012010000000010100000101000100110000101111010000000000011000001
1010000100001101000110110001000100000100001001000100110001100020100001000011
1000101001000100001110000000001000001000001001100000110000000020011001011001
1000000110110000010100000100111011000000000110000000000000100000000010100011
1000010010000000110000000000101000000100002100010000110010000010100000000001
1110000010000101110101102000100000001111000010000001010001100100011000000001
1100000001000020000021011001110000001001000000000000000000000100201000101001
1101100111110010001100011000111000011010000100110001000000110010002000000011
1001000100000010000000000001100100110010110001000100020200101000010102100001
1010011001000100000010000100100110000010010001000101000000001000010010100011
1100000000000010111101100011001011110000000101000010010000000101000010100001
1100010110000001002000101100000001000000001000011010010101110010000001100001
1001100100001010010010101010100000100100010110202001000111010101001011111001
1100011001100001000002000000201111000200010101201000110000000000010000200001
1110112000002100000001000101010100010201010010010021021201001000011101000001
1010001000000001000000000000011100200100002111000000000010001001000200100111
1010101000000000011001001010000021010000010200011110001011001000010010000101
1000000100000010000000120010000000000000100010011001001000110100100010110011
1100000101001100001001002001001000000110000010000021001000101010000000000001
1001000111000000000001000100020010100000101110001101000100000000100101002001
100000000010100101001110100S100000000100000010110010120000000001000101001001
1100001100022000000000010110001000100100110011000100020000001011000110110011
1110101010011100000110001000100110000101001000010001100001000000012110100001
1000100002110101010000010000000010011000000000000100110000011000101100000101
1000000110001000102100022002001010010000100001101000110000000001000200010001
1000000010011000100000010110110000000110000000000000100000000001000100000021
1010210000010000101001011101120000001100000110110000000020021100000010000101
1010000100010001100010101000000100010101010000111000000000000011000000200111
1000100000100001000001000100010001010001000002000000011120100110000000001001
1101110000002010200011111000000001000000000110010000000000100100210000001001
1001010000000120021020101001001100000001011011110000101100021001001001200001
1000100100000010000201000000000100001002001020000001010001010000020001000011
1000100100120101000000001110110101120010000000001000011000010010211000000011
1001000111200000010100100000010010211000011000110000001100100010001000000011
1000111000000000000110001000000110100111000001000101000000001000000000000101
1000000011000000110000000120100001121001100000111000010001000000100001010001
1011101101000000210000000001000011100101001000002010001010101000000100111101
1010011001000000100000000001002000000001000010001010101001000100010001000011
1010000100010120001020001020111000000110121010200011100000110111000000001011
1101000100110010000000001011101200002000111000002000100011000001010000000101
1001100000000000000001000200000000100001010000000000000100000001101000110011
1110001100000000001000000010100101000000101011010110000000000020101110001101
1000010000000000010000000010110010000000001011010102000100000000100000110001
1001101100100010001110000001100000000001000110001001001100000100010101000001
1020110210021111000000000000000000000200010010000201000000100020010000000101
1101100002100011000011000100011001100000000100000110110100110011100010010101
1000001000001120000101000010101100000011100000100000110000001110001000000001
1110100001001000000010000000001000001010100010000020100100000001002001010001
1021100001100001000011000001101001002110000001000110100000000001000110011011
1110000000100110001010000100101000100010000000002100000100010022210100001001
1001000011200200200000101100011000010100010011001000011100011100100001000001
1000110010001101011010000100001101001000010020010020101001011010010000011001
1000100112000011000000101011010100002100000101100101002120010000101011110101
1100000000010100200000000000011000010010010001000000000001100000000120010001
1100011100110000021000110211010001100000100011111101000020100100001000000101
1000110110000011011000011000001000000100010001001010110000100100000000000001
1001000000000101000110001000100010100000000100001201000001010010000001000011
1011010000010101100001000101210000000000100000111011010102000102001000111011
1100100001000001010001011010000100010000010010100000001000001000000001101021
1000001000100000110000000000000010000101010001000010011000011100010000100101
1020100110000010010110111000010001000010100000100010100201002000000001000001
1000000100000110100100010011010000100100010000002100111101000001000000101011
1001001000000000000100000101001010001020000010000001000000101110000000000101
1000001000000001110000011110000000120000000001101121120010000000100010001001
1111111111111111111111111111111111111111111111111111111111111111111111111111
