R 900 600
NO  textures/eagle.xpm
SO textures/redbrick.xpm
WE textures/purplestone.xpm
EA textures/greystone.xpm
S textures/designcactus.xpm
F 255,255,    255
C 0, 126,   233

11111111111111111111
11111000111010111111
12110011100101010011
10001101111012120001
10211001010110110111
11012011101100120111
10011111011010011111
12001010010021111011
10111101010000000001
11101011001101100111
10001001100100000211
1211110110102000001
112010101011001100W1
10110000010000111211
10010100102100001011
11002020120100002001
11020101100002012001
10010102102010000101
10110012111001010011
11111111111111111111