R 1920 1080
WE textures/colorstone.xpm
NO textures/colorstone.xpm
SO textures/colorstone.xpm
EA textures/colorstone.xpm

S textures/others/beer4.xpm
C 195, 160, 70
F 106, 107, 77    


        1111111111111111111111111
        10000000001100000000W0001
        1011000001110000002000001
        1001002000000020000000001
111111111011000001110000000000001
100000000011000001110111111111111
11110111111111011100000010001
11110111111111011101010010001
11000000110101011100000010001
10000000000000001100000010001
10000000000000001101010010001
1100000111010101111101111000111 
11110111 1110101 101111010001
11111111 1111111 111111111111