R 5 5
WE textures/wood.xpm
NO textures/redbrick.xpm
SO textures/purplestone.xpm
EA textures/greystone.xpm

S textures/barrel.xpm
C 222 ,112, 255
F 123, 111, 0
   1111111      1111111
  111              1111
1111111111111111111111111111 
11111100000000111111111111
1111110000000001111111
111100000000000000W111
11111100000000000111111
110111111000000000011111
111110010000011000111111
1111111111111011111111    
       1010000011   
11111111111111111
  1110111
