R 1920 1080 
NO ./textures/wood.xpm
SO ./textures/mossy.xpm
WE ./textures/colorstone.xpm
EA ./textures/redbrick.xpm
S ./textures/barrel.xpm
F 25,25,25
C 0,126,233

1111111111111111111111111111111111111111111111111111111111111111111111111111111111111111111111111111111111111
1000000000000000000000100100000011000000000100010000110100000001010000000000100001101020000120010100010001001
1001010001010000000000000000000011000001000100010001110000020000100000000000001010001010010000000101000001001
1000000001000000000000000000001020001001100100000010000010000101010000000100010010010100001000000000000001001
1000000000010000100000000010100001001010000001000000000010000100100100100100000000000010100001000000000010001
1000001100000000000000000000000000000000000000000100001000010000000000001000101000000000000000000010000000001
1000010000010000000000000000010000000001000000010000100001000000010110000000010000000001100000100000010001001
1000010000000001000100010000000010000000100120001000100000000000100000000111001000100000000100000000000100011
1010001100000000000000000000000000000000010000001000000000000000102000100000101100100000010000000000000100001
1000000001110000000000000001001000100000000101000000010000000000010000010000200000000010001000001000000000001
1000010100000000000010001000000100010000001001000002000000000000000000010001100000000000100000000000000000001
1000000001000000000000001000000000001000010000000000000000000001100010000100000000010000000001000001001010001
1001000000010000020000010000000002010000000000001000000011000000001000000000000010000000010011000011000001011
1001000000001000010010001001000100101001000000001000100020010000000110000001010000010010000010100100010000001
1010000000001100010010101000100000001000000000010010010000000001101000000000000000010010000000001011000100001
1100000000100000000000000100000200000000000000000000000000000110001011010000000010001001000000000000001000101
1001000001100000000000000000000000200000000001010001001000001000001001001000011000000001001010000010000000001
1021000000110000001010000000000000000000110000000000010000100000000000200000000100000200000100100000100001101
1001000000200000000000000001002000000000100000000000000000000010000001000100000000000000000000000000100000001
1010100000000000011101001100011000000001000000001000100001000000000010120100020000000000000001020000000000001
1000100011010001000000010000000100000000000010010010001111000000001000010000010000000000011001000000000000101
1010000000000000000000000010100000000000000000000000000000000000100000000001010000010000000000001000101000001
1101001000100010100000100101000000000100010001000000000001001111000000000010000000000000020001001000000010101
1000000000100000110100000000000001000000100000000000000000000000000001000000000101000010110010100000000000001
1000000000001000000100100000100000010010000000001000001000000000000000001000010000010010000010000100000101001
1000100101000011000001000000100000010001000001001000001000010002001100011000100100010001110000000000000000001
1000000000000100110011000001010000010000000001001000011101000000001000001000000000020100001001000010010011001
1000011110000000000010201002010000000001001100000000100000000101000100000000000001000000010001000000000000001
1010000000000001000100110000001121000000010001001000010001000100000000000000000000010000001000000001011000001
1000010000101000000100000110001000100000011020000000000000010001000010000000100000010000000000000000000010201
1000000020200000100000110000000000100110000000000000100001001000100120000000000020001000100100100010011100011
1000000000000000000000000001001000000000100000010000000000000000000021000001000000100000000110000100000001001
1010000020002101100000100000000100000100010000200100010000010000000000000000100100010011000000000000001000001
1000010000011001000000100010001010000010000010101010000100001110001100000000001000000000000001100000000000011
1000001000100000000001000000000002000000100000100000100100010000000000000000000021100000000010000000000010001
1000000000000000020000000200100000010001000100100100000000000000001010010001000000200000010101001000000001001
1001001000001000000000000000020001000001001000000010000000110000000000000001000100000000000010200000010000001
1000000001100011001000000000000200021000000000100000000001010010000101000000000000000010011000020001000100001
1000000000010110000000001001000000000000000000000000100100100010000001000010010000000000000000000000000100001
1000000000010001110000000000010000000000010000100000000000000000000000000110000000000010000011101000010010001
1010100000000000000001000000010000000000011000000000001000000000000001000000000000010000000000000100010000001
1000100000000000000000000100000000000001100000001000002000001010000001010100000010001000010000100002000000001
1110001010001000010000000000000001100011001101200111000001000000000001100010000000000000000001000000010000011
1000100000000000000000010110010001000000001000010000001000000000001000000120201000010000100000000001010000011
1000000000001010010001001000000000000000001100010000000010000000000000100110000000000000001000100000111000001
1010000200001000000000100100010020000000000001000000001000010000000100000010000000000000000100000000000100001
1111000011000000000000000001010000000000000000000011000000020000011000000001000100010000000000000010010000001
1000000100100000100010000100000000000000000001000001000000110000000000000000010000000010000000010000000001011
1000010000000000000000000000000000010100000000000001000000100100100000010000000000000200010000000000101000001
1010000000000000000000000010000000000110000000000000000002000100110000010000000010000100000000000000110000001
1000000010000001010000010000000000000000010000010000000001001000000000000000000021000001000000000100000000111
1000000011010000000000001000200000010000001200000000000000101000000000000000020000000000000000100110010000001
1000010101100000000000000001000100000000101010000101000000000100000001000110001000102000000010000000001000001
1000001000200000011011010001000000000000000000010001000100000000001000011001001101000000010001011000010000001
1000100000000110000010000000002010000001000000010000000000000000000011011000010011000010010000000011000010101
1100011000000000000000110100000010000000001000100010000001001100100000001100000010000000000010000000000100101
1100000000100000000000001010100010001011010100101010000100000010000100001100000200000000000000100000000100001
1000000000010000101110000000001010100000010110000010010000010100010010100000000100000000100000000000000000011
1000011000000100000000110000000100100102000001000000001000010000000000010020001000010000000000000000000000011
1020000000000001100011110000101001000000000101010000001000000020010000001000000000100000012000001000102010001
1000101000000000000001000101012000000000000000000000000100000000000101000000000000000000000100001000000000001
1000100000000011011100002000100121101001000000010000001000110000000000010000001100000100002000010010000000001
1010000100001100000000010100011000001000001000000100200010020100100000001000002100100000001200001000100010001
1000100000000000000000000000000000110000000020010001000011000000101010000001100001000000000000000001100000101
1000000000000101101000000000100001201010000000000000021100000000000000000000001001001000210001000020000000101
1000010000110000000000010000000000100000010000100000000100010001001000001100002000200000000020000100000000011
1010000100100000000011200001010000100000000010001010000001000001000101000001000101100000101000000000000000001
1000000000000010101101012000010000001000000001011000001000100010000210001010000011000001000210000000010000001
1020000100000000000001000110100010110010010000011000001000000000000000000110000010010010002000000001000000111
1000000010020000001000100000000100010001000000010201020000001000000111020100000001101000100000010000101012001
1000000000000000100000000000001001000000000010000000000100000010000000000002000001000100000000010020000100001
1000000000011001000010000000000010012000000001100000000000010001010000010100000001010000101000010010001010011
1200021000000000001001000000000000000000001100000000000000100000000011000000001000000000000000010010000000101
1000000010000000000001000000011000000000000001000000000000000000011001000000001000000010020000000000000000001
1000010000110001000000100000000000100000020000000001000000000000101001000000011010000000000000000001001000001
1001110000000000000000000000100010000001200001000001100001001100100020111001000020100000001000001011010001101
1000000000000100000000000000100000000210000000001000010000010010000100100000100000000000100000001010000000001
1000000000000000000000000000001000000000000001010000101100000000000000001000000110000000100000100110000012001
1000000110000122000000110000000000001010001100000000000100010101000000010000000000000000001000000000001100011
1100000000000001000000001000100021101011000000000000001000000100101011000000100011000000000000110000001000101
1000000000010010001000000000000000000100000000000000000100000100100100010100100020000000101101000000000000101
1000211000001000000000100100000000100000100000021000010000010100001000000000101010000000000000000000000000001
100000010000000000000000010000000010000000000000N100000001000010001010000001000001000001001000002100000000011
1000100000000000001000001000000000000000011000001000000102000100000000000000000000000000010100000010100100001
1000000210000100000000000000000100000001010000001000000010100000000000001000001200000000000010000100100000001
1000000010010000000000000010001000000000102000001001010000001000100000000000011000000000100000100000000000201
1110000000001100000210000100001001000000002100000001110000010000000000000000000000100000100000001010010100011
1000000000020000100000000000000000010100000000010000001111000100000100000000100020020100100000000100011001001
1101000000010100000000001010001000000010000001001001011002000000010000000000020000000000011100000000000001001
1002000000001000000020000100001000010020000210001000010010010010001000000100001000000000001000100000000110001
1001000000000010101010100000000100000000100000001000001000000100000000100021000100000100100000010000000000201
1001000000000001000000000001000000000000000011000001001100000000000101000000000000000110100010100000000100001
1010000000001010000000000000001000000000000000000002010000000010000010100000001000001000100000000000000100001
1000000010000000100000010000001010000000200000001100000100000000010000010100010000000100000000001000000000001
1001000100200000000000000100001010000001111000000010200101000000200000000001000000000001100001010000100010001
1001000000002000000000010000001000000000100000100000000001000001100000000010000000200111002000001000010000001
1001010100000000000020111011000100000001000000000000100000011000020010000010100101000000000100000000001000011
1110000000000001000000020000000101000011100000001010110000100010001000001000001000010000110000000010010000111
1001010200000000000000010010000000000000100020000020000011100101101000000000000010000001001100000000010000001
1001000000000020100100100000000100000010000000000101010000010000000010000001010101010000000000100010100000001
1000000000000011000010000000000000001000000000000000020000000000002000000000000000021000000000200000000100011
1010000000000000000000000000000000100000000000000000000000000000100010000001001000000000000011000000001010001
1000011000010000001000000000100100000000000102001000011000000000000000101001001010000000000000011000000001001
1111111111111111111111111111111111111111111111111111111111111111111111111111111111111111111111111111111111111
