R 1920 1080 
NO ./textures/wood.xpm
SO ./textures/mossy.xpm
WE ./textures/colorstone.xpm
EA ./textures/redbrick.xpm
S ./textures/barrel.xpm
F 25,25,25
C 0,126,233

1111111111
1111010101
1101010201
1010121011
1000101111
1110111001
1010011101
11E0101011
1010110011
1111111111
