R 1920 1080 
NO ./textures/wood.xpm
SO ./textures/mossy.xpm
WE ./textures/colorstone.xpm
EA ./textures/redbrick.xpm
S ./textures/barrel.xpm
F 25,25,25
C 0,126,233

1111111111
1000001001
1010000201
100S010001
1100000001
1000000001
1000000001
1000000001
1000000001
1111111111
