R 1920 1080 
NO ./textures/wood.xpm
SO ./textures/mossy.xpm
WE ./textures/colorstone.xpm
EA ./textures/redbrick.xpm
S ./textures/barrel.xpm
F 25,25,25
C 0,126,233

11111111111111111111111111111111111111111111111111111111111111111111111111111111111111111111111111111111111111111111111111
10010000000000101100000020000000000100000000000010000000100100000100000001000000000000000000000001000000000000100000100001
10001000001110101000011000100000020000000000000000100000100000100010100100011001000010010200000000000000000000000010000011
11110010001102000201000000000010000100111110001001010100000000010000000001001000000100100000010000010001000000100010000001
10000000001000001010110001000000000000001001100000000000000000000000001100001000110000100110000000000100000001000000000201
10000000000100000010000100000000100000000000000000110000000001100001100000000010001210001001100001000000010010001101110001
10000110010000000000000000200100000100100000110010000010000000100000010000010000110000000000000000001110000000000100100021
10111011000001000000000000010000000001000001001001010000010012010011000100100000001000000000000000110000110000100000001121
10000020001000000100000010000001000000001000000000001102000100100001001000000000000000010010100000000000000000010000010001
11110010000010000010000102100100001001000010000100100100000000001000001010100100000001202010000100000000101000001000010001
11010000001010000000000000000010002010110110000010000000011100001000001000110000000000000000010000000010101000010000110001
10000000000010000010100001100010010002000011100211000111010010110010000000010000101000001000001100000000000000000001000101
10000100010000100200000200001010011001010000100000000001001000001000100000000000000000000100010100100100010000001000010001
11000010000110000000000010201000000000200000000110000000001001000001000000000000100000100100100000011010101010010010100001
10000000000000001100001010010010000000110001001000000000200001010000110000000000000100000000011000001010200000100000000001
10100101000000000101001001001000000000000010101111000000000001000001000000010000001001000010200000001000000010000000200001
10100000100000001000100000000001000000100000010101000001000000100000120100100000000010010101000000000002000000101101010001
10000000111000000001012000110000101001110001000000001000011000000000000000000110001101000000100000000000001000000200200001
10000000001000000000100000010000000010100000000000001001000000100110101000000111000000001000000000000020200102101100000001
10000000000000000110001011010100010000000000001100000101010000000100001100000100000001000000000000000001000000000000000001
10001000000000100002000000100100100000100000010011011000000000000001010000000000000000000010000000101000000011000010001001
10010020101000000012100010000000000110000000100020010000010000000111100000000001000010001000000000100001100001011001000001
10000000100000002010000000000100001000000011000000000000000000000001000000101010100000100100000001110010001000000000000001
11000000100100000101000100000100001100011000000000000000000010000000001000000100000000100000201001010000001000100000000011
11000001101101011000001010100001000000000100011000000100010000200100000000000010000000000001100000000100000100000000000011
10000000000101010010010000010010010000100201000001110000110001100000000010000100000010000000010000000000100000000010100101
10001000101100000010000011100001000001000000100000100010010000000011000001000000100000120100100101000000000001001100000011
11100000000000201000001000000001000001200010010000000100101000100000100000001000000001000000000000000100000010000000100021
10100000100001000000000000000102000000001100000000000000000000000000000000000000000101000010000000002000000010001001000101
11000010010010010010000001000101120000000001010100000001000000000001001101000001200100000001001010000001000210020000001001
10200011100000000101000000001000000000000010000011000000000110000000000001000000010001000000100000200000100000100010000001
10010000010000000000000000001010000000010000000000010020000010011010110000000100000000000000000000100000000111100000100001
10100100010000000000000000000000010010001010010000000000000001000000000000000100000000000000101100001001000100000011101001
11002001010000000001010001000101100000000000010200000000000001010011100000101100020010000100100000000001000000000000000011
12001002001010101101000001010010000001100020200101000010011000110000010000000001100100000000010000000000001012100000010001
10100010000000010000000000010000000011002000010000000001000000000100000000000100001111020000100000000002010000100100000011
10000010100000000010000000101000100001000000000000001000001000010000000010000000000000000200000000000000010000000000000101
10000000000010100000000001010010000101000000000002201000001000000010110010000010000200000020010020000020000000100000000101
10100000001000121020001000101000001001000000001001100000000000001101000001000000011010010001000000000010000000001000020011
10000020100000001010000000100201010010001000001000210110000000020010000100100000000100000100000000010000000010100110101001
10000001000100010000011000111001000100000000002000010000000020000000000100000020010010000000000011001000001000010000000001
12002000000110000000001000001011102001100000000210111000200000000100001000011000011001000000210010000100002001100100000001
10100010011000000000000000000000011110000010000102002011000000000000100010000001010010010021100101000010000110000000000001
10000000001001000000001000010001001000000001000110000000000101001100000000000000011010100000100000000020000011000000001001
10110201000001110000000000000011100010000110000001000000000000011000000010000000100100100100000000001001000000010011100001
10001020100000000010001100000000010000010100000100110000010101200000000001000100000000000101000100000110000000000001000001
10100000010100020000010000000000100001001001100000000000000110000001100000010100000100100100000000000000100001010010010001
11000001000000001000100001001100000000000000001000100000002000002001100010001210000010100000000010101100100001000100000011
10000000001000000001011100010000001100000100000001000000010010000100100100000000000110000000021100000210101000000001000001
10000000000100010000000010001001000100000000000000101000010100010000001001001011000000010000000000000100001100000100000001
10000000001100001000000110000020120000100000000000101000000001000001000000010101000210000200000100000000001100110010110011
10000001001000001000000000000100100010010010010001001011000000200000000010000011100001000001000000000121010020000001000001
100N0000000001000000001000200000000000001210000000000000000000001011000000100000000010010101000000010000011101001001112011
11000010010010100021000000110010000000000000000100100010211000010010000000000000000000010100001000010000000001010020000001
10000000010001000000200100000001110000000001000000011010110001010010000010000010000000110001100011000010001000000000000001
10001020110000000000000000010000101000200001012000000011012010000001111010000100001000001021101000100000102001000000000101
11000000000001011100010200120010100000000100000100010002000010010000021001001001010000100201110001000100110000000101210001
10001000010000000010000000101021000010100000000000000100001001001001010000000110000000000000000020000100000000101010100001
10000000010000000000000000000000010000010000001100000102020000000000020100000000110000100000000100000100000000000000110001
10000010011000000000000100000011010000000000000000000001000001100010100200000001000102000110000000000000100000001201000011
10100000000000000010110000100000100000000000000000000100001010000000000000001000001012100000101000011000010100000002000001
10000010000020000000001100000001001000100000000000002000000000001000000000000001001000000101000000002000120010100120010001
12000020101000010001000000000000010000220010010000000010120110000000000000000010000000010110020110001000001000001000001011
10011000000000000011000000110110000000000000000000100000001110000120001100101100010000000000000000001000001000000101000001
10201000001000000200010000000000000010001010000010000001100000010110100000000000021001100010101100000110010000010111010111
11101101100000200001210101100000001010110000000000011000001000000010001000000011010100010000000000200000000000000000110001
10000010000000000000000001020000000000100000001200010000100000000000000000000100001001000000101000100000000200000010002001
11000110000000000000000020000010010001000000000000000000000110001101000110100001010001000200000000001100001000012010000001
10001000000000010001001000000000012000000000011000000000001000100010010000001010000001000110000000010100000001000000001001
10002000000010000000100000100110001120100100000000000000100000000020000000000011000010000110000000100000000100000010001001
10000100000010000010002001001100000000010001110000020001000000000011010010000001000100010010111000010010010010000001000101
10000000100010000100001010002002000000001100001001010000000000000000010000010000000001000001000111000010000000011000100011
11001000000000000001000100000000001102000000010000000000000000000000000200010000000000000000000001000200000000000020000001
10010210000000000000010000000000010010001010000001000200010200111010101000000000000100000001000110100100000000000010100111
10000000000010000200000200000000021001000100001110000020000001000001010000000010000000000100000000000001000000001000000001
10000010000010001000000000001000000001000000000100000000011000000001100000000100000100000000000000000000000002100000020001
10000000021000000000000100010000000000200000000100000100000000000000000001000001000210100000001100001001000000000000011121
10000000000200000000000000000100000001000010000000110000000100000000110100000000111000110000100101010101001010000000010111
10000000100000000000000000010000000011010002000000000000100011000000001200201000000000010000000000000100011000000000000011
10000100000000100101102000000100010200010010000000000000100020000000000100001000000110000010001100010000100000011101000001
11010010000001002000000100000201000200102100010010000000100000010100000000010000000101000000000010011000100000000000000011
10000000010010001110000000101000001011000010100000100000010000002000001000100000001010011000010000000000100100000001001011
10000000011000100102010000011000000001000100000010000000000000100200000111000020001000000000000000000100000100000000000001
10001000110000000101010100001001200001102000100001001000100001000000000000000000201000000000000000010000000101010010100001
10100010000010100100100000000010000000100001002100102000100000000000002000100120210000000100000100100100001010100001001001
10000010000110011000000001010110000000100011001000010000000100010001000000000100100101000100000000012001001000000101000001
10000001000011000010001010000000100001000110000010000001001000001010000100101000000100001000010101000001000100000000000001
11001000000001000000000010102000011000000100010000000002001001000000010000000000001010000100001011011000000001000001001101
11010100000000201000000000000000010000100100010000100000010010000101001000000000000001010000000011100000001010000000000011
11100201100000000000110000110000200101000000000010000200000000200000000101000001000100010100010101100000000000000001000111
10010001000000000000101000100112001000001210001000000000000000000100000012000011000001100010001000010000000001100000000001
10000000100010010100000100000002200010110200100020000000010000000000010011000000000010100100110200000000000100001000010001
10010020100000010000101000010101101000000100000100001001100000001000000001010000000000011100000000010200000010000000000201
10010000000000000100000110020000000001000000000001000110000000010101100000000100000000100100001010000000101000001011001001
10000001001100010001000100000010001110000100001100000000000000000000111100000001100001100000000000001010010000000010001011
10101000000000020100001000000000210001100000001000000020000000010000002000000001010000001000100100010001000000000000000001
10020000100100000000000001000000000000001000000001020000000000001000001000010000000000002000010000000100100000000000100021
10010010000001000000020010010100110000210000100100120102000000010000001010111001000002000000100001120000001001000000000101
10100000000010010000000001020000011000110000001000000000010110000100001000001000000001010000010100002100000000200000000001
10000001000011000020000010000100001100001010000000001000000001110000000000010001000010000001000000000000001001010000000011
10000000001012001100000000000100100000000000000000001001000101100000000000001001001001010101000000000000000000000100001001
10001101010000001100010200100110001000010000100010000000001100100010000000000000000000001010000001001001100001000000000001
10000000100010000010000000200000000100001000000010000021000000000020001000001000000000010001000000001022100010000000010201
11000010000010000000001002000100001100000000010101100000012000000011100000000100010100000000000000000000000010101010000001
11111111111111111111111111111111111111111111111111111111111111111111111111111111111111111111111111111111111111111111111111
